1. Причинно-следственные связи и логика
jo – потому что
tādēļ – поэтому (официально)
tāpēc – поэтому (причинно-следственная связь)
tātad – значит (логическое следствие, вывод)
dēļ – ради, из-за
nevis – а не, вместо (противопоставление)
tomēr – все же, несмотря на это
taču – но, однако, хотя
lai – чтобы
lai gan – хотя
kaut – чтобы, как бы, что
it (kā) – будто бы, словно
gan – и, хотя, действительно
savukārt – в свою очередь
turklāt – также
tā kā – так как
piemēram – например
nosacīti – условно, относительно
tas ir atkarīgs no tā, – это зависит от того
jo tāpēc – вот почему
tā rezultātā – в результате
lai arī – несмотря на то что
par spīti tam – несмотря на это
tiklīdz – как только
ja vien – если только
gadījumā, ja – в случае, если



2. Время и частота
kāmēr – в то время как
arvien – всегда
joprojām – всё ещё
tikko – только что
nesen – недавно
sen – давно
tūlīt – немедленно
uzreiz – сразу
pēkšņi – внезапно
brīžiem / reizēm / dažreiz / brīžam – иногда, временами
turpmāks – следующий
pērn – в прошлом году
vienmēr – всегда
bieži – часто
reti – редко
ik pa laikam – время от времени
beidzot – наконец
agri / vēlu – рано / поздно
ilgi – долго



3. Усиление и степень
ļoti – очень
tiešām – конечно, несомненно
tieši – именно, как раз
īpaši – особенно
gluži – совершенно
gandrīz / teju – почти, чуть ли не
diezgan – довольно, достаточно
noteikti – определённо
pilnīgi – полностью
itin – вполне, совершенно
vismaz – хотя бы, как минимум
savā ziņā – в некотором роде
ārkārtīgi – чрезвычайно
bezgalīgi – бесконечно
neiedomājami – невообразимо
vienkārši neticami – просто невероятно
tik – настолько
visvairāk – больше всего

4. Эмоции и мнения
cerēt – надеяться
sapņot / sapnis – мечтать / мечта
gandarījums – удовлетворение
sajūsma – восхищение
sašutums – гнев
prieks / priecāties / priecājies – радость, радоваться
skumjas / skumjš – грусть, печальный
vilties – быть расстроенным
viedoklis – мнение
patiesība – правда
mele – ложь
dusmas – злость
bailes – страх
rūpes – забота
pārliecība – уверенность
šaubas – сомнения
nožēla – сожаление
brīnums – удивление
apbrīns – восхищение
riebums – отвращение



5. Взаимоотношения
atteicības – отношения
laulība / precēties / precējies / šķirties / šķīries – брак, жениться, женат, разводиться, разведен
pateikties – поблагодарить
apsolījums / solījums – обещание
atbalstīt – поддерживать
pierast – привыкнуть
pateicīgs – благодарный
priekšrocības un trūkumi / trūkums / priekšroka – плюсы и минусы, недостаток, предпочтение
draudzība – дружба
konflikts – конфликт
strīds – ссора
sadarbība – сотрудничество
komunikācija – общение
uzticība / neuzticība – доверие / недоверие
vienošanās – соглашение
šķiršanās – расставание



6. Работа, действия, решение
risināt / atrisināt – решать
uzdevums – задание
izdevums – издание, затраты
veikt – выполнять
sniegt – предоставить
sasniegt – достичь
tikt / tikt pie / tikt galā – попасть, получить, справиться
ieguvums / panākums / uzvarēt / zaudēt – приобретение, успех, победить, проиграть
censties / sekot – стараться, следовать
apgūt – овладеть
iemesls – причина
atgādināt – напомнить
plānot / plāns – планировать / план
organizēt – организовать
vadīt / vadība – управлять / руководство
izstrādāt – разработать
paveikt – совершить
pieteikties – подать заявку
iesaistīties – вовлечься
pārvaldīt – контролировать
mērķis – цель

7. Передвижение и направление
doties / ierasties / nokļūt – отправиться, прибыть, добраться
nākt / nākties – приходить, быть вынужденным
mosties – проснуться
izcelties / izrauties / izlauzties – выделяться, прорваться
apstāties – остановиться
pārvietoties – передвигаться
pagriezties – повернуть
iziet / ieiet – выйти / войти
aizbraukt / atbraukt – уехать / приехать
nonākt – попасть
apmeklēt – посетить
uzkāpt / nokāpt – подняться / спуститься



8. Мышление, восприятие
likties / šķist / izskatīties / izrādīties – казаться, выглядеть, оказаться
justies – чувствовать
uztvert – воспринимать
skatīties / skatīt / raudzīties – смотреть, обозревать
vaicāt – интересоваться
aizrautība – увлеченность
attaisnojums – оправдание
saprast – понимать
iedomāties – представлять себе
atcerēties / aizmirst – помнить / забыть
vērtēt / novērtēt – оценивать
domāt / uzskatīt – думать / считать
spriest – рассуждать
pamanīt – заметить
ievērot – обращать внимание

9. Характеристики и качества
būtisks – существенный
vienkārši – простой
grūts / sarežģīt – сложный / усложнять
milzīgs – огромный
krāšņs – великолепный
skaļš / kluss / kliegt – громкий, тихий, кричать
vājš – слабый
resns – толстый
čakls – трудолюбивый
mērķtiecīgs / spītīgs – целеустремлённый / упрямый
laipns / nelaipns – вежливый / грубый
drosmīgs / bailīgs – смелый / трусливый
izglītots / neizglītots – образованный / необразованный
atvērts / noslēgts – открытый / замкнутый
gudrs / muļķīgs – умный / глупый
godīgs / negodīgs – честный / нечестный
pacietīgs / nepacietīgs – терпеливый / нетерпеливый
kārtīgs / nekārtīgs – аккуратный, организованный / неорганизованный
jautrs / skumjš – весёлый / грустный
strādīgs / slinks – трудолюбивый / ленивый
dāsns / skops – щедрый / скупой
uzticams / neuzticams – надёжный / ненадёжный
pārliecināts / nepārliecināts – уверенный / неуверенный
mierīgs / nervozs – спокойный / нервный
sirsnīgs / auksts – душевный / холодный
atsaucīgs / vienaldzīgs – отзывчивый / равнодушный
ambiciozs – амбициозный
egoistisks – эгоистичный
humoristisks – с чувством юмора



10. Пространство и указания
te / tepat / lūk – здесь, вот здесь, смотри
savādāk / atsķirīgs no – по-другому, отличается от
tur / šeit / šur – там / здесь / сюда
iekšā / ārā – внутри / снаружи
blakus – рядом
augšā / lejā – наверху / внизу
priekšā / aiz muguras – впереди / позади
pa kreisi / pa labi – налево / направо



11. Семья
onkulis – дядя
tante – тётя
brālēns / māsīca – двоюродный брат / сестра
māte / tēvs – мать / отец
māsa / brālis – сестра / брат
bērns / bērni – ребёнок / дети
vecmāmiņa / vectētiņš – бабушка / дедушка
vīrs / sieva – муж / жена



12. Коммуникация
paust – выразить
saistība / saistīts ar – связь, связанный с
skatīt / skatīties – смотреть
pateikties / paust / vaicāt – поблагодарить, выразить, спрашивать
sarunāties – разговаривать
runāt / teikt / stāstīt – говорить / сказать / рассказывать
skaidrot / paskaidrot – объяснять
ziņot – сообщать
atbildēt / jautāt – отвечать / спрашивать
kliegt / čukstēt – кричать / шептать



13. Общество и политика
ārlietas / ārpolitika – иностранные дела, внешняя политика
sabiedrība – общество
valsts / valdība / prezidents – государство / правительство / президент
vēlēšanas / balsošana – выборы / голосование
likums / noteikums – закон / правило
pilsonis / pilsonība – гражданин / гражданство



14. Прочее
nu / teiksim – частицы
piemēram – к примеру
ievilkt – втягивать, вдыхать
iezīme / nozīme – черта, значение
miers – мир, спокойствие
kopt / kopa / kopā – ухаживать, группа, вместе
ļaut / atļaut / pieļaut – позволять
spert / sperties – пинать / метнуться
izdalīt – распространять
krūts – грудь
mīlulis – любимец
algot – нанимать
pirkt – покупать
vaļā – открыто, свободно
paradumi – привычки
veiksme / neveiksme – удача / неудача
ikdiena – повседневность
dzīvesveids – образ жизни
notikums – событие
pieredze – опыт
daba / vide – природа / среда
veselība / slimība – здоровье / болезнь
drošība / risks – безопасность / риск

